BastionHostRequired	false	-
CatalinaOpts	-	-
CidrBlock	0.0.0.0/0	-
CloudWatchIntegration	Metrics and Logs	-
ClusterNodeInstanceType	c5.xlarge	-
ClusterNodeMax	1	-
ClusterNodeMin	1	-
ClusterNodeVolumeSize	50	-
CustomDnsName	-	-
DBEngine	PostgreSQL	-
DBEngineVersion	9	-
DBInstanceClass	db.m5.large	-
DBIops	1000	-
DBMasterUserPassword	****	-
DBMaxIdle	20	-
DBMaxWaitMillis	10000	-
DBMinEvictableIdleTimeMillis	180000	-
DBMinIdle	10	-
DBMultiAZ	true	-
DBPassword	****	-
DBPoolMaxSize	20	-
DBPoolMinSize	20	-
DBRemoveAbandoned	true	-
DBRemoveAbandonedTimeout	60	-
DBStorage	200	-
DBStorageEncrypted	false	-
DBStorageType	General Purpose (SSD)	-
DBTestOnBorrow	false	-
DBTestWhileIdle	true	-
DBTimeBetweenEvictionRunsMillis	60000	-
DeploymentAutomationBranch	master	-
DeploymentAutomationCustomParams	-	-
DeploymentAutomationKeyName	-	-
DeploymentAutomationPlaybook	aws_jira_dc_node.yml	-
DeploymentAutomationRepository	https://bitbucket.org/atlassian/dc-deployments-automation.git	-
ExportPrefix	HALO-	-
HostedZone	-	-
InternetFacingLoadBalancer	true	-
JiraProduct	Software	-
JiraVersion	8.5.8	-
JvmHeapOverride	-	-
KeyPairName	-	-
MailEnabled	true	-
QSS3BucketName	aws-quickstart	-
QSS3KeyPrefix	quickstart-atlassian-jira/	-
SSLCertificateARN	-	-
TomcatAcceptCount	10	-
TomcatConnectionTimeout	20000	-
TomcatContextPath	-	-
TomcatDefaultConnectorPort	8080	-
TomcatEnableLookups	false	-
TomcatMaxThreads	200	-
TomcatMinSpareThreads	10	-
TomcatProtocol	HTTP/1.1	-
TomcatRedirectPort	8443	-

